70
###############
#    !        #
#           a #
#   ^         #
#      %      #
#             #
#  +     &  * #
########D######
#  *          #
#     %       #
#  !      & ^ #
#         #D# #
#  $ &    #*# #
###############