70
###############
#   +  &  *   #
#   %       ^ #
#######D#######
#         & * #
#a    !   %   #
#######D#######
#  &     ###*##
#  *     ###D##
#     %  # %  #
# !      #    #
# &      D   &#
# *  +   #   *#
###############