50
###############
#           ! #
#  *   a      #
#             #
#             #
#  !          #
#      $      #
#          &  #
####          #
#* D$         #
####       %  #
#             #
#  ^      +   #
###############